+-+-+-+-+-+
|   |   | |
+-+ +-+ + +
| |       |
+ + + +-+ +
| | |   | |
+ +-+ +-+ +
| | | | | |
+ + + + + +
|       | |
+-+-+-+-+-+
